#####____####
#__#_____####
#__#_____####
#__##____####
_~~###__##__#
_~~~_________
_~~~_________
____##__##__#
#####____####
####_______##
####_______##
#####____####